30 seconds=30 секунд
1 minute=1 минута
2 minutes=2 минуты
5 minutes=5 минут
10 minutes=10 минут
30 minutes=30 минут
1 hour=1 час
2 hours=2 часа
Above=Выше
Array must be Started to view disk stats=Для просмотра статистики по дискам массив должен быть **запущен**
Array must be Started to view system stats=Для просмотра системной статистики массив должен быть **запущен**
Available for Data=Доступно для данных
Below=Ниже
CPU Load=Нагрузка ЦПУ
Disk Usage=Использование диска
disks=диски
High on Usage=Высокая загрузка
Last day=Последний день
Last 2 days=Последние 2 дня
Last 3 days=Последние 3 дня
Last week=Последняя неделя
Last 2 weeks=Последние 2 недели
Last 3 weeks=Последние 3 недели
Last month=Последний месяц
Low on Space=Мало места
Normal Usage=Нормальная загрузка
Real-time=В реальном времени
Since start=С момента запуска
Storage=Хранилище
Total Array Size=Общий размер массива
Total Space Used=Использовано места
Used for Parity=Используется для чётности
utilization in percentage=занятое пространство в процентах