%s ago=%s назад
%s used of %s %s %%=%s занято из %s (%s %%)
1 m=1 м
10 s=10 с
2 m=2 м
30 s=30 с
5 m=5 м
Abort background operation=Прервать фоновую операцию
Abort background process=Прервать фоновый процесс
Active tunnels=Активные туннели
Activity=Активность
ago=назад
Airflow=Охлаждение
Alert Message=Предупреждающее сообщение
Alerts=Оповещения
All Apps=Все приложения
All VMs=Все ВМ
Array Information=Информация о массиве
Attention - operation continues in background=Внимание - операция продолжается в фоновом режиме
Battery charge=Зарядка батареи
BIOS dated=BIOS датирован
Check free space=Проверить свободное место
checking=проверка
Click to toggle CPU chart=Переключить диаграмму ЦПУ
Click to toggle details=Переключить подробности
Clock is unsynchronized with no NTP servers=Часы не синхронизированы, нет серверов NTP
Clock synchronized with %s NTP server=Часы синхронизированы с сервером NTP %s
Clock synchronized with %s NTP servers=Часы синхронизированы с серверами NTP %s
Clone=Клонировать
Close Tile=Закрыть элемент
Completed=Завершено
Containers=Контейнеры
Content Management=Управление содержимым
Counters info=Счетчики
Current operation %s on %s=Текущая операция %s на **%s**
custom image=пользовательское изображение
Data is invalid=Данные недействительны
default image=изображение по-умолчанию
Docker Containers=Контейнеры Docker
Docker folder=Папка Docker
Docker vdisk=Виртуальный диск Docker
Due in=Через
Edit VM after clone=Edit VM after clone=Редактировать ВМ после клонирования
Elapsed time=Прошедшее время
emulated=эмулируется
Errors info=Ошибки
Estimated finish=Расчётное время завершения
failed device=вышедшее из строя устройство
Fan count=Количество вентиляторов
Fan Information=Информация о вентиляторах
FAN=FAN
Finding %s error=Найдена: **%s** ошибка
Finding %s errors=Найдено: **%s** ошибок
Flash device=Флеш-устройство
Free=Свободно
General info=Основное
Go to CPU pinning settings=Перейти в настройки привязки к процессору
Go to date and time settings=Перейти в настройки даты и времени
Go to disk settings=Перейти в настройки дисков
Go to Docker settings=Перейти в настройки Docker
Go to fan settings=Перейти в настройки вентиляторов
Go to identification settings=Перейти к настройкам идентификации
Go to network settings=Перейти в настройки сетевых интерфейсов
Go to scheduler settings=Перейти в настройки планировщика
Go to Share settings=Перейти к настройкам общего доступа
Go to UPS settings=Перейти к настройкам ИБП
Go to User settings=Перейти в настройки пользователей
Go to VM settings=Перейти в настройки виртуальных машин
Go to VPN settings=Перейти в настройки VPN
Handshake=Рукопожатие
has=имеет
healthy=в порядке
heat warning=предупреждение о перегреве
heat warnings=предупреждения о перегреве
Hide details=Скрыть подробности
in progress=в процессе
Inactive tunnels=Неактивные туннели
inactive=неактивный
Inbound=Входящий
Information=Информация
Interface Information=Информация об интерфейсе
invalid=недопустимый
invalid device=недопустимое устройство
invalid devices=недопустимые устройства
Last check completed on %s=Последняя проверка завершена в **%s**
Last check incomplete on %s=Последняя проверка не завершена в **%s**
Last checked on %s=Последняя проверка в **%s**
Legend=Легенда
Lock sortable items=Заблокировать элементы для сортировки
Log filesystem=Файловая система логов
Maximum size=Макс. размер
Memory Utilization=Использование памяти
Mode of operation=Режим работы
Motherboard Information=Информация о материнской плате
Network traffic=Сетевой трафик
New VM=Новая ВМ
Next check scheduled on %s=Следующая проверка запланирована на **%s**
No docker containers defined=Контейнеры Docker не определены
No running docker containers=Нет запущенных контейнеров Docker
No running virtual machines=Нет запущенных виртуальных машин
No shares present=Нет общих ресурсов
No virtual machines defined=Виртуальные машины не определены
Nominal power=Номинальная мощность
not received=не получено
Notices=Уведомления
Notifications=Уведомления
Only PNG images are allowed=Разрешены только изображения в формате PNG!
Outbound=Исходящий
Output voltage=Выходное напряжение
Overall Load=Общая загрузка
Overwrite=Перезаписать
Parity disk not present=Диск чётности отсутствует
Parity disks not present=Диски чётности отсутствуют
Parity has not been checked yet=Чётность еще не проверена
Parity Information=Информация о чётности
Parity is degraded=Чётность ухудшена
Percent of total used memory=Общий процент использования памяти
Percent usage of Docker folder=Percent usage of Docker folder=Процент использования папки Docker
Percent usage of Docker vdisk=Процент использования виртуального диска Docker
Percent usage of flash usb device=Percent usage of flash usb device=Процент использования флэш-устройства USB
Percent usage of LOG file system=Процент использования файловой системы логов
Pool=Пул
Power Status=Состояние питания
Power=Питание
Processor Information=Информация о процессоре
Put system to sleep=Перевести систему в спящий режим
RAM usage=Использование ОЗУ
Reboot the system=Перезагрузить систему
Receive counters=Счетчики приема
Received packets=Полученные пакеты
Runtime left=Оставшееся время выполнения
Scheduled parity check is disabled=Запланированная проверка чётности отключена
Select Case Model=Выберите модель корпуса
Select time frame=Выберите временной отрезок
Services=Сервисы
Share count %s with %s cache only and %s encrypted=Общих ресурсов: %s с %s только в кеше и %s с шифрованием
Shares Information=Информация об общих ресурсах
Show details=Показать подробности
Show Information=Показать информацию
ShowHide All Content=Показать/Скрыть весь контент
ShowHide Content=Показать/Скрыть контент
Shutdown the system=Отключить систему
SMART error=Ошибка SMART
SMART errors=Ошибки SMART
SMART health-check failed=Проверка SMART провалена
SMART=SMART
sn=с/н
Snapshot Name=Имя снимка
Snapshot=Снимок
Start Cloned VM=Запустить клонированную ВМ
Start the array=Запустить массив
Started only=Только запущенные
Stop the array=Остановить массив
synching=синхронизация
Temp=Температура
This may leave an unknown state=Это может оставить систему в неизвестном состоянии
This will put the system to sleep=Это действие переведет систему в спящий режим
This will reboot the system=Это действие перезагрузит систему
This will shutdown the system=Это действие отключит систему
This will start the array=Это действие запустит массив
This will stop the array=Это действие остановит массив
Tile Management=Управление элементами
Transmit counters=Счетчики передачи
Transmitted packets=Переданные пакеты
Unassigned Devices=Неназначенные устройства
Unlock sortable items=Разблокировать элементы для сортировки
UPS Load=Нагрузка ИБП
UPS Model=Модель ИБП
UPS status=Статус ИБП
Usable size=Полезный размер
User count %s with %s unprotected=Количество пользователей: %s с %s незащищенными
Users Information=Информация о пользователях
utilization warning=предупреждение о чрезмерном использовании
utilization warnings=предупреждения о чрезмерном использовании
View Running Processes=Показать запущенные процессы
Virtual Machines=Виртуальные машины
VM Being Cloned=Клонируемая ВМ
VM Clone=Клон ВМ
VM Name=Имя ВМ
VPN Connections=Подключения VPN
W=Вт
Warnings=Предупреждения
ZFS=ZFS