Access Mode=Режим доступа
Add another Path, Port, Variable, Label or Device=Добавить другой путь, порт, переменную, ярлык или устройство
Add Configuration=Добавить конфигурацию
Add=Добавить
Additional Requirements=Дополнительные требования
Always=Всегда
App to Host=От приложения к хосту
Application=Приложение
apply update=обновить
Are you sure=Вы уверены
Array must be Started to view Docker containers=Массив должен быть **Запущен** для просмотра контейнеров Docker
Autostart=Автозапуск
Back=Назад
Backup=Резервирование
Beta=Бета
Books=Книги
By=От
Categories=Категории
Check for Updates=Проверить обновления
Cloud=Облако
Config Type=Тип конфигурации
Configuration not found=Конфигурация не найдена
Connection Type=Тип соединения
Console shell command=Консольная команда
Container ID=ID контейнера
Container Path=Путь к контейнеру
Container Port=Порт контейнера
Container Size=Размер контейнеров
Container=Контейнер
CPU Memory load=Загрузка ЦПУ и памяти
CPU Pinning=Привязка к процессору
Created=Создан
Crypto Currency=Криптовалюта
Default Value=Значение по умолчанию
Device=Устройство
Display=Отображение
DNS=DNS
Docker Containers=Контейнеры Docker
Docker Hub URL=URL-адрес Docker Hub
Docker Service failed to start=Сервис Docker не удалось запустить
Downloaders=Загрузчики
Drivers=Драйвера
Edit Configuration=Изменить конфигурацию
Exited=Завершен
Extra Parameters=Дополнительные параметры
Fixed IP address=Фиксированный IP-адрес
force update=принудительно обновить
FTP=FTP
Game Servers=Игровые сервера
healthy=в порядке
Hide Buttons=Скрыть кнопки
Hide docker allocations=Скрыть распределения Docker
Hide more settings=Скрыть дополнительные настройки
Home Automation=Домашняя автоматизация
Host Path=Путь к хосту
Host Port=Порт хоста
HT=HT
Icon URL=URL-адрес значка
Image ID=ID образа
Key=Ключ
Label=Ярлык
LAN IPPort=LAN IP:Port
Lock sortable items=Заблокировать сортируемые элементы
Management=Управление
MediaApp=Медиа-приложение
MediaServer=Медиа-сервер
Messenger=Мессенджер
Missing parameters=Отсутствующие параметры
Music=Музыка
Network Type=Тип сети
No Docker containers installed=Контейнеры Docker не установлены
None Listed=Нет в списке
of=из
orphan image=несвязанный образ
Other=Другой
Overview=Обзор
Path=Путь
Pause All=Приостановить все
Photos=Фотографии
Port Mappings=Соответствие портов
Port=Порт
Post Arguments=Пост-аргументы
Privileged=Привилегированный
Productivity=Производительность
Project Page=Страница проекта
Proxy=Прокси
Pulling image=Получение образа
Read Me First=Сначала прочти меня
Read Only - Shared=Только чтение - Shared
Read Only - Slave=Только чтение - Slave
Read Only=Только чтение
ReadWrite - Shared=Чтение/Запись - Shared
ReadWrite - Slave=Чтение/Запись - Slave
rebuild ready=пересборка готова
rebuilding=пересборка
Remove template=Удалить шаблон
Removing container=Удаление контейнера
Removing orphan image=Удаление несвязанного образа
Repository=Репозиторий
Required=Обязательно
Reset sorting=Сбросить сортировку
Resume All=Возобновить все
Save=Сохранить
Select a template=Выберите шаблон
Select categories=Выбрать категории
Show docker allocations=Показать распределения Docker
Show more settings=Показать дополнительные настройки
Stable=Стабильный
Start All=Запустить все
starting up containers=запуск контейнеров
Stop All=Остановить все
Stopping container=Остановка контейнера
Successfully removed container=Успешно удален контейнер
Successfully removed orphan image=Успешно удален несвязанный образ
Successfully stopped container=Успешно остановлен контейнер
Support Thread=Тред поддержки
Template URL=URL-адрес шаблона
Template=Шаблон
The command failed=Команда не выполнена
The command finished successfully=Команда успешно выполнена
TOTAL DATA PULLED=ВСЕГО ПОЛУЧЕНО
Total size=Общий размер
Unknown action=Неизвестное действие
Unlock sortable items=Разблокировать сортируемые элементы
Update All=Обновить все
update ready=готов к обновлению
Value=Значение
Variable=Переменная
Video=Видео
Voip=VoIP
Volume Mappings=Соответствие разделов
wait=ждать
Was this container created using this plugin=Был ли этот контейнер создан с помощью этого плагина
Web=Веб
WebUI=Веб-интерфейс
Writable=Записываемый

; Note: April 21, 2025 - 23 missing translations
3rd Party=
Addresses=
available=
Compose=
Container IP=
Container not found Try reloading this page to fix=Container not found. Try reloading this page to fix.
Container not running=
DERP Relay=
Error gathering Tailscale information from container=
Exit Node=
Expired RenewDisable key expiry=Expired! Renew/Disable key expiry!
For security reasons, containers with Network Type Host should not have Tailscale enabled Please disable Tailscale in this container or change the Network Type of the container=For security reasons, containers with Network Type "Host" should not have Tailscale enabled. Please disable Tailscale in this container or change the Network Type of the container.
Hostname=
Is Exit Node=
Key Expiry=
Online=
Please check the logs and refresh the page=
Please check the logs=
Real Hostname=
Routes=
Tailscale=
update available=
URL=
