%s An update is available=%s: Доступно обновление
anonymous=анонимный
Author=Автор
Check For Updates=Проверить обновления
Checking connectivity=Проверка подключения
checking=проверка
Click here to install version %s=Нажмите здесь для установки версии %s
Delete Plugin=Удалить плагин
DOWNGRADE TO VERSION=ОТКАТИТЬ НА ВЕРСИЮ
Enter URL of remote plugin file or local plugin file=Введите удалённый URL файла плагина или ссылку на локальный файл плагина
ERROR=ОШИБКА
Install Plugin=Установить плагин
Install=Установить
install=установить
Installed Plugins=Установленные плагины
Installing Update=Установка обновления
need check=требуется проверка
Next=Далее
No plugins installed=Плагины не установлены
No release notes available=Примечания к выпуску отсутствуют
No response, aborting=Нет ответа, прерывание
Plugin File=Файл плагина
Plugin File Install Errors=Ошибки при установке файла плагина
Plugin History=История плагина
Plugin Update Check=Проверка обновлений плагинов
Plugin=Плагин
Release Notes=Примечания к выпуску
Remove Plugin=Удалить плагин
remove=удалить
Select local plugin file=Выберите локальный файл плагина
Stable=Стабильный
STALE=УСТАРЕВШИЙ
Support Thread=Тред поддержки
Uninstall=Удаление
Update All Plugins=Обновить все плагины
Update Plugin=Обновить плагин
Upgrade=Модернизация
View Release Notes=Посмотреть примечания к выпуску
